111111111111
1E0000011101
10100CC01101
1010000CC001
1P00C0100C01
111111111111