111111
11C0E1
1P0001
111111

111111